0,1,1,1,1,1,1,1,1,1,1,0
0,1,1,1,1,1,1,1,1,1,1,0
0,1,1,1,1,1,1,1,1,1,1,0
0,1,1,1,1,1,1,1,1,1,1,0
0,1,2,3,4,1,1,2,5,4,1,0
0,1,6,7,8,1,1,6,0,9,1,0
0,10,11,7,12,13,13,11,14,12,13,0
0,15,16,17,18,19,19,20,21,18,19,0
0,19,22,23,24,19,19,22,0,25,19,0
0,1,26,27,28,1,1,26,29,30,1,0
0,1,1,1,1,1,1,1,31,32,32,0
0,1,1,1,1,1,1,1,33,34,35,0
0,36,37,38,32,39,31,32,40,41,1,0
0,42,40,34,43,41,33,44,45,41,1,0
0,46,35,47,33,41,33,41,48,47,1,0
0,4,1,1,33,42,40,41,1,1,49,0
0,8,1,1,48,35,35,50,1,1,37,0
0,12,13,13,13,13,13,13,13,10,11,0
0,51,19,19,19,19,19,19,19,19,52,0
0,1,53,54,37,4,37,4,37,4,1,0
0,55,56,57,58,59,60,61,62,59,4,0
0,63,64,65,66,67,68,69,70,67,30,0
0,1,26,30,26,30,63,71,72,30,1,0
0,73,1,73,1,73,73,73,73,49,73,0
0,1,73,74,73,73,73,1,73,73,75,0
0,76,73,77,78,1,49,1,77,79,1,0
0,0,80,81,0,80,82,73,0,0,73,0
0,0,83,0,0,0,73,78,0,0,77,0
0,83,84,0,0,85,86,0,0,0,0,0
0,0,0,0,0,0,0,0,0,83,0,0
0,0,0,0,0,0,83,0,87,88,0,0
0,0,0,0,0,0,0,0,89,90,0,0
0,0,0,0,0,0,0,0,0,0,91,0
0,0,92,93,94,0,0,0,0,0,95,0
0,0,96,97,98,0,0,0,0,83,0,0
0,0,99,100,101,83,0,0,83,84,0,0
0,0,0,0,83,0,0,0,0,0,0,0
0,0,0,0,0,0,0,0,0,0,0,0
0,0,0,0,0,0,0,0,0,0,0,0
0,0,0,0,0,83,0,0,85,0,0,0
0,0,83,83,0,83,0,102,0,0,0,0
0,0,0,0,81,0,83,0,0,83,0,0
0,0,0,103,14,83,104,0,105,0,0,0
0,0,0,0,83,83,14,0,106,0,0,0
0,0,0,0,14,0,0,102,0,0,0,0
0,0,105,107,0,83,0,0,14,0,0,0
0,108,109,110,0,84,0,83,0,0,0,0
0,0,106,0,14,0,83,84,0,0,0,0
0,0,0,111,0,108,112,0,0,105,0,0
0,0,0,106,83,0,84,0,113,97,110,0
0,66,0,0,0,81,0,0,0,106,67,0
0,114,0,0,103,115,116,117,0,0,8,0
0,118,0,0,0,119,120,121,0,0,8,0
0,114,0,105,0,122,123,124,0,83,125,0
0,26,126,127,128,29,29,29,29,29,30,0
0,1,1,49,1,1,1,73,73,1,1,0
0,4,37,5,4,37,129,4,37,129,4,0
0,8,114,0,8,114,0,8,114,0,8,0
0,130,131,0,59,131,0,59,131,0,59,0
0,132,0,0,0,0,0,0,0,0,0,0
0,0,0,0,0,84,0,0,0,0,0,0
0,0,0,83,0,87,133,0,0,0,0,0
0,0,0,0,0,89,90,0,84,0,0,0
0,0,0,0,0,0,0,108,110,83,134,0
0,0,0,0,0,14,83,0,0,0,135,0
0,0,67,66,134,67,66,14,67,66,136,0
0,137,138,139,140,138,114,0,8,114,141,0
0,142,30,26,143,30,26,29,30,26,144,0
0,129,4,37,129,4,37,5,4,37,145,0
0,0,8,114,0,8,114,0,8,114,136,0
0,0,8,114,14,8,139,146,147,114,141,0
0,148,149,114,0,8,114,0,8,114,0,0
0,0,8,150,146,147,114,102,8,114,84,0
0,0,8,114,0,8,114,0,9,114,0,0
0,29,30,26,29,30,26,29,30,26,29,0
0,5,4,37,129,4,37,129,4,37,129,0
0,0,8,114,0,8,114,0,8,114,0,0
0,0,59,131,83,59,131,148,151,152,0,0
0,0,0,0,0,81,0,0,136,136,83,0
0,0,0,0,103,83,83,104,141,105,0,0
0,0,0,0,0,83,83,14,141,106,0,0
0,0,0,0,0,153,148,148,154,155,0,0
0,154,148,156,0,141,83,0,0,0,0,0
0,136,108,109,110,0,0,0,134,0,0,0
0,157,0,158,66,0,67,66,159,67,66,0
0,114,137,138,114,0,8,150,140,147,114,0
0,26,29,30,26,29,30,26,142,30,26,0
0,49,160,161,162,49,1,160,161,162,75,0
0,1,163,1,164,1,1,165,1,164,1,0
0,1,166,167,168,1,49,166,169,168,49,0
0,1,1,49,37,129,129,4,75,1,1,0
0,170,1,1,114,0,84,8,1,49,160,0
0,164,1,49,114,83,103,8,75,1,165,0
0,168,49,75,26,29,29,30,1,1,166,0
0,171,172,173,1,37,4,1,174,13,13,0
0,19,19,175,1,114,8,1,176,19,19,0
0,19,19,175,75,177,178,1,176,19,19,0
0,129,179,180,1,181,182,75,183,184,185,0
0,14,186,8,1,187,188,1,114,159,140,0
0,0,159,8,189,131,59,36,114,0,159,0
0,0,0,8,48,66,67,50,114,0,0,0
0,0,190,191,1,114,8,1,114,14,0,0
0,0,7,8,1,114,8,1,114,83,0,0
0,0,7,8,189,58,59,36,114,0,0,0
0,0,7,8,48,66,192,50,193,146,0,0
0,0,7,8,1,114,8,1,114,0,0,0
0,0,194,191,1,114,8,1,114,0,23,0
0,0,0,8,1,114,8,1,114,0,96,0
0,84,0,8,1,114,8,1,114,83,195,0
0,0,67,30,1,26,30,1,26,66,81,0
0,0,8,1,1,1,1,1,1,196,93,0
0,29,197,13,171,172,13,198,172,199,127,0
0,1,200,19,201,19,19,19,19,202,1,0
0,1,203,19,19,19,19,19,201,52,1,0
0,19,19,19,204,140,140,205,19,19,19,0
0,137,140,206,207,140,140,146,137,140,146,0
0,0,159,83,137,208,140,146,0,159,0,0
0,0,0,83,0,159,209,133,0,0,83,0
0,0,0,0,83,0,89,90,0,0,0,0
0,0,0,0,0,0,0,0,0,0,0,0
0,0,0,0,0,0,0,0,0,0,0,0
0,0,0,0,134,0,0,0,0,0,0,0
0,210,210,211,142,66,0,81,0,0,0,0
0,210,210,212,184,131,0,14,0,0,0,0
0,0,0,0,159,0,0,83,0,0,0,0
0,0,0,0,0,0,0,0,0,0,0,0
0,0,0,0,0,0,0,134,0,0,0,0
0,0,0,0,0,0,67,142,213,210,210,0
0,0,0,0,0,0,59,179,214,210,210,0
0,0,0,0,0,0,0,159,0,0,0,0
0,0,0,0,0,0,0,0,0,0,0,0
0,0,0,215,216,0,0,0,0,0,0,0
0,0,0,0,0,0,0,0,134,0,0,0
0,0,0,0,0,0,0,134,159,0,0,0
0,134,0,0,0,0,137,217,142,66,83,0
0,140,146,0,0,0,0,8,1,114,103,0
0,142,143,66,0,83,0,8,1,114,0,0
0,1,1,114,0,104,83,8,1,26,66,0
0,1,1,114,0,83,67,30,1,49,26,0
0,1,82,26,29,29,30,1,1,73,73,0
0,1,1,34,161,162,1,1,218,1,1,0
0,1,73,41,1,164,73,74,73,73,73,0
0,1,1,42,169,168,1,73,73,74,80,0
0,1,1,1,1,1,1,82,74,77,0,0
0,1,77,79,82,1,219,220,77,0,0,0
0,78,0,0,73,80,154,148,0,0,0,0
0,0,0,0,221,0,136,0,0,0,0,0
0,0,0,0,0,0,141,0,0,0,0,0
0,0,0,14,0,0,0,0,0,0,0,0
0,0,0,0,83,0,0,0,0,0,0,0
0,0,0,0,0,0,102,0,0,84,0,0
0,0,0,0,0,0,0,14,0,0,0,0
0,0,0,0,84,0,83,0,0,0,0,0
0,0,0,14,0,83,84,0,0,0,0,0
0,0,84,0,0,0,0,0,0,0,0,0
0,0,0,0,0,0,0,0,0,0,0,0
0,0,0,0,0,0,0,0,0,0,0,0
0,0,0,0,0,83,0,0,85,0,0,0
0,0,83,0,0,83,0,0,0,0,0,0
0,0,0,0,0,0,83,0,0,0,0,0
0,0,0,0,14,0,0,0,0,0,0,0
0,0,0,0,0,83,0,0,0,0,0,0
0,0,0,0,0,0,0,102,0,0,0,0
0,0,0,107,0,0,0,0,14,0,0,0
0,0,0,0,0,84,0,83,0,0,0,0
0,0,0,0,14,0,83,84,0,105,0,0
0,0,0,0,0,0,0,0,0,106,0,0
0,0,0,0,0,83,0,0,0,0,0,0
0,0,0,0,0,0,0,0,0,0,0,0
0,0,0,0,0,0,0,0,0,0,0,0
0,0,102,0,0,0,0,0,0,0,67,0
0,0,0,83,0,0,190,222,29,29,30,0
0,0,0,0,0,0,7,8,1,1,1,0
0,0,0,0,0,0,223,197,173,1,1,0
0,84,0,0,0,67,224,225,226,1,1,0
0,0,136,0,0,8,1,227,228,10,13,0
0,0,154,148,229,151,4,230,231,232,232,0
0,0,136,0,0,233,8,1,203,234,235,0
0,14,236,0,0,0,8,1,1,1,1,0
0,0,136,14,0,0,59,129,129,237,129,0
0,0,141,0,0,0,0,0,148,154,148,0
0,0,0,0,0,136,0,0,0,136,0,0
0,66,0,0,0,141,0,136,0,141,0,0
0,238,239,148,148,154,148,154,0,0,0,0
0,26,143,66,0,136,0,141,67,29,29,0
0,129,4,114,0,136,0,0,8,37,129,0
0,84,8,238,148,154,148,240,241,242,243,0
0,105,8,114,0,244,0,0,8,114,104,0
0,245,30,26,29,142,29,29,30,26,29,0
0,162,74,1,74,246,1,1,82,1,1,0
0,48,45,1,1,1,1,1,160,161,161,0
0,32,40,1,73,1,1,1,163,1,1,0
0,247,74,73,73,73,82,74,166,32,248,0
0,136,77,249,74,77,73,1,1,49,73,0
0,154,250,251,252,154,80,1,253,254,255,0
0,233,84,0,0,256,0,78,141,141,73,0
0,0,0,0,0,141,0,0,141,83,257,0
0,0,0,0,0,0,83,0,87,88,0,0
0,0,0,0,0,136,0,0,89,90,0,0
0,0,0,148,148,154,148,0,0,0,91,0
0,0,92,93,94,136,0,0,0,0,95,0
0,0,96,97,98,141,0,0,0,83,0,0
0,0,99,100,101,83,0,0,83,84,0,0
0,0,0,0,83,0,0,0,0,0,0,0
0,0,0,0,0,0,0,0,0,0,0,0
0,0,0,0,0,0,0,0,0,0,0,0
0,0,0,0,0,83,0,0,85,0,0,0
0,0,83,0,0,83,0,0,0,0,0,0
0,0,0,0,0,0,83,0,0,0,0,0
0,0,0,0,14,0,0,0,0,0,0,0
0,0,0,0,0,83,0,0,0,0,0,0
0,0,0,0,0,0,0,102,0,0,0,0
0,0,0,107,0,0,0,0,14,0,0,0
0,0,0,0,0,84,0,83,0,0,0,0
0,0,0,0,14,0,83,84,0,0,0,0
0,0,0,111,0,108,110,0,0,105,0,0
0,0,0,106,83,0,0,0,113,97,110,0
0,0,0,0,0,81,0,0,0,106,0,0
0,0,0,0,103,115,116,117,0,0,0,0
0,0,0,0,0,119,120,121,0,0,0,0
0,0,0,105,0,122,123,124,0,83,155,0
0,0,108,97,110,0,83,0,0,0,0,0
0,0,0,258,0,0,0,0,0,0,0,0
0,0,0,0,0,0,102,0,0,0,0,0
0,0,0,0,0,0,0,83,0,0,0,0
0,259,0,0,0,0,0,0,0,0,0,0
0,132,0,0,0,0,0,0,0,0,0,0
0,0,0,0,0,84,0,0,0,0,0,0
0,0,0,83,0,87,133,0,0,0,0,0
0,0,0,0,0,89,90,0,84,0,0,0
0,0,0,0,0,0,0,108,110,83,0,0
0,0,0,0,0,14,83,0,0,0,0,0
0,0,0,0,0,0,0,14,0,0,0,0
0,0,0,0,0,0,0,0,0,0,0,0
0,0,0,107,0,0,0,0,0,0,105,0
0,0,0,0,0,0,0,0,0,81,260,0
0,0,0,0,0,0,0,0,0,0,0,0
0,0,0,0,14,0,0,0,0,0,0,0
0,0,0,0,0,83,0,0,0,0,0,0
0,0,0,0,0,0,0,102,0,0,84,0
0,0,0,0,0,0,0,0,14,0,0,0
0,0,0,0,0,84,0,83,0,0,0,0
0,0,0,0,14,0,83,84,0,0,0,0
0,0,0,84,0,0,0,0,0,0,0,0
0,0,0,0,83,0,0,0,102,0,0,0
0,0,155,0,0,81,0,0,0,0,83,0
0,0,0,0,103,83,83,104,0,105,0,0
0,0,0,0,0,83,83,14,0,106,0,0
0,0,0,0,0,14,0,0,0,0,0,0
0,0,0,105,0,0,83,0,0,0,0,0
0,0,108,109,110,0,0,0,0,0,0,0
0,0,0,106,0,0,0,0,0,0,0,0
0,0,0,0,0,0,0,104,0,0,0,0
0,0,0,0,0,0,0,84,0,0,0,0
0,0,0,0,0,0,0,0,0,0,0,0
0,0,0,0,0,0,0,0,0,0,0,0
